NO textures/wolfenstein/purple_stone.xpm
SO textures/wolfenstein/eagle.xpm
WE textures/wolfenstein/red_brick.xpm
EA textures/wolfenstein/wood.xpm
F 20,20,20
C 200,200,200
111111111111111111111
1W00000N0000000E00001
111111111111111111111
