WE textures/wolfenstein/grey_stone.xpm
NO textures/wolfenstein/purple_stone.xpm
SO textures/wolfenstein/red_brick.xpm
EA textures/wolfenstein/wood.xpm
F 20,20,20
C 200,200,200
111111111111111111111
10000000000000000000000001
                      1W000000000000000000000001
10000000000000000000000001
10000000000000000000000001
111111111111111111111
