NO textures/wolfenstein/purple_stone.xpm
SO textures/wolfenstein/eagle.xpm
WE textures/wolfenstein/red_brick.xpm
EA textures/wolfenstein/wood.xpm
F -1,21,22
C 201,202,203
111111111111111111111
1W0000000000000000001
111111111111111111111
